11111111111
1C001010101
11010P00111
100E0001001
11111111111