11111111111
10001010101
11010101101
10000001011
11111111111